     111111111    
     100002221    
     101002221    
     101100221    
11111103030111    
122230303411      
122103030311111111
122210303000000001
122203030013131101
100111103030301001
1001 1100300030001
1111  110001111111
       11111      
