     1111111 
     1001001 
     1003301 
111111031001 
1222111010011
1200100301001
1200003030301
1200100301001
1222111010011
111111030001 
     1401001 
     1111111 
