    111111    
  1110000111  
  100013000111
  100030003301
  103301300001
  110003000301
11111101311111
1224013001    
1212200311    
122223101     
122220001     
111111111     
