       1111         
111111110011111     
100000000010001     
100001011001001111  
11001000001000000111
 1000110001033310001
 1000000000100030301
 1001001010131041011
 111100303010003001 
  10301111101110311 
  1002222222222201  
  1110011111110011  
    1111     1111
