11111111111
10000100001
10343333301
10000000001
11111011111
   12001   
   12001   
   12221   
   12001   
   11111   
