 1111111       
 10010011111   
11001001222111 
10031001222001 
10301330222001 
10031001222021 
100010311111111
113000000030301
110010033010001
 11111100113341
      100000011
      11111111 
