     11111  
1111 100011 
10011101001 
103022221011
100112252001
100003113101
103130003001
110401113101
 11111 10001
       11111
