111111111111111
100000010000001
103013010311301
101003010000001
100011313113301
101010222010001
103002001002301
103143222101001
100002010200301
101123111320101
101032222201101
100000000000001
111111111111111
