     11111    
     14001111 
  11111300001 
  122210010311
  125213013001
11122203010101
10022113100001
10011110010301
11000300013301
 1001101100011
 111110000001 
     10011111 
     1111     
