111111111         
100010001111111111
100303001000122221
110303030300122221
 14303030303252121
 10303030303252121
110303030300122221
100303001000122221
100010001111111111
111111111         
