 1111  11111
11001  10001
103011113001
100322220301
110000104011
 1111111111 
