      111111111
      100000001
      101010101
      100303101
111111100030001
122100110303101
122000110303001
122100110111111
122101030301   
122000003001   
100111040111   
1111 11111
