  111111
  100001
11133301
14032201
10322211
1111001 
   1111 
