        11111111 
        10000041 
        10313011 
        1030031  
        1130301  
11111111103010111
12222001103003001
11222000030030001
12222001111111111
11111111         
