11111111111    
100011222211111
100300222110001
111330221110101
  1011222113001
  1010001110011
 1101030030301 
 1001010000001 
 1000010301301 
 1033010310011 
 111011001011  
   140000001   
   111111111   
