   1111111     
   100000111111
   103100000001
111130030013301
100003303000301
103100110111011
10411303003001 
10000030030301 
11111111113301 
  122222222211 
  12222222221  
  11111111111  
