  11111111
  10001201
 110032221
 100301521
1101131011
1000300301
1000100001
1111111401
      1111
