       1111   
11111111001111
10001122222001
10030011222101
11003001110101
 1010300100001
 1001030010001
 1000103001001
 1000010301011
 111100103001 
    110010301 
     11410001 
      1111111 
