  11111          
11100011         
10001001         
10103301111111111
10330001100100001
11000301003330101
 1013033030100301
 1003021222223011
1114112211212111 
10010012222221   
10000000003111   
100000010001     
100000111111     
1111111          
