1111111  
100230111
102323001
153232401
102323011
10023001 
11111111 
