 1111111            
11000001            
10011101      111111
10300001111111122221
11010130010032222221
 1303030013035222221
 1003000030301122221
 1013310010001111111
 1030011110011      
 103030001101       
1100303300001       
1400010001001       
1111111111111       
