1111111            
1001001     1111
1030031111111001111
1001002222222031001
1101001112111000301
 101100012141311001
1101113012101001011
1000000312101000001
1000113012100031301
1111110030001001001
     11013101111111
      1000001      
      1111111      
