11111111        
10001001        
10300001111     
1101130140111111
 100303113001001
 101003010302221
 103013000012221
 100000110312221
 111030100302221
   1110100312221
    100330011111
    10000011    
    1111111     
