  1111111111    
  1000010001    
  1031000301    
  1030313101    
 111212220011111
1100222213010001
1031211510033301
1000222224103001
1001212220030301
1033003131003001
1000100100100011
111111000011111 
     111111     
