 1111111111111 
 1000010011001 
 13330103300311
 10300100222201
 10030013211201
 10010310222211
113030013211201
103003043222201
100011100111111
11111 1111
