      11111     
11111110001     
10001120001     
100312200111    
1100222133011111
 103212300000001
 103111311010301
 100010000033101
 113310113130001
 122203403000111
 1222131000111  
 12220011111    
 1111111        
