1111111111
1100000001
1000131301
1033002321
1041112221
1111111111
