         11111  
         10001  
1111111111050111
1000000000020001
1033335555322241
1000000000020001
1111111111050111
         10001  
         11111  
