          111111
          100001
11111   11101101
1220111110300101
1220000030003101
1220011011000101
1220110301303101
1220100000300101
1220100301113001
1220103030030111
111011010300001 
  1000014110301 
  1111111110011 
          1111  
