             111111
  1111  11111100001
 110011110010300301
 100000033010003001
 100101110013300011
 10010011011001301 
110011010343003031 
122221010001001001 
122221011311030301 
122221010011100011 
12222103001011111  
11111101001        
     111111        
