  111111111
11100010001
10032050301
10121212101
10303430301
10121212101
10305023001
10001111111
11111      
