11111111       
10000001       
1033000111     
10030333011111 
110110222000011
 10141222111301
 10103222000001
110103222301011
10011111011101 
10000003000301 
11111111111001 
          1111 
