       11111111
       10010001
  1111110332221
 10000000012221
 10111111312221
110100000012221
100101303011111
10103030301    
10400301001    
11111303301    
    1000001    
    1111111    
