  11111        
  1000111111111
  1030300000001
111110030133001
100010110000111
1222000110031  
1222133003001  
1222100410011  
111111111111   
