        11111    
        100011111
        101311001
        100003001
11111111101110001
12222001103003111
1222200003033011 
1222200113003041 
1111111110030011 
        10303001 
        11101101 
          100001 
          111111 
