111111111111  
12200100000111
12200103003001
12200131111001
12200004011001
12200101003011
11111101130301
  103003030301
  100001000001
  111111111111
