       11111
  1111110001
111000020301
103001321311
100100421001
110111120001
 10300151111
 1011012001 
 1000002101 
 1113000001 
   10011111 
   1111     
