 111111111 
 100010001 
 103333301 
1103030301 
1030040001 
10301111011
10012222201
11002222201
 1111111111
