    11111      
11111000111111 
100000100110011
101033000300001
100100011010101
103010110003001
100003030001011
11030100131101 
 1110010101031 
   10300402221 
   10311312221 
   11000222211 
    111022211  
      111111   
