    111111111       
  111000110011111   
11100000010010001111
10033013010010022201
10100314311010121201
10011013001000022201
10310000301010121201
10000110011303022201
10301100010013121201
11033003000300322201
 1300111111000011001
 10001    1111111111
 11111              
