   11111   
 111000111 
1100430301 
10011011011
10321230001
10121510001
10322200111
111310111  
  10001    
  11111    
