  11111    
  10001    
11132311111
10002030001
10113110401
10002011111
1110201    
  10001    
  11111    
