     111111
 1111120001
 1001221101
 1003220001
 1001021011
11101131001
10300003301
10131001001
14001111111
11111      
