     1111    
1111110011111
1430000300301
1311103010101
1001001030001
1031000010111
100301310001 
122222222201 
111111110001 
       11111 
