11111111          
122200011111111   
1222200000300011  
1222221103013001  
1222221001003001  
111111130110030111
 10000000011103001
 10030103001003001
 10011101100101111
 1001003003010001 
 1111013100113001 
  143000030003001 
  111110001111111 
      11111       
