   111111  
111110001  
103002001  
103022111  
143033111  
11102320111
 1132223001
 1032110001
 1000111111
 11111     
