11111111
10010001
10322301
14325011
10322301
10010001
11111111
