111111   11111
10000111 10021
10030301 12221
10100301110021
10033300030421
11100300310021
  100313012221
  110000010021
   11111111111
