   1111111   
1111000001   
1000211101   
10101000011  
10103031201  
10100500101  
10213030101  
1100001010111
 101112000041
 100000110001
 111111111111
