  11111 
1110041 
10032011
10023201
11105301
  100011
  11111 
