1111111
1202021
1033301
1234321
1033301
1202021
1111111
