 1111 
11001 
14301 
113011
110301
123001
122521
111111
