     11111111     
  1111000000111111
  1000011030300041
  1011011313030311
111022222210033011
100022222210010001
101022222213003001
101022222203310301
103011101113003011
11100300300300301 
  100300300300301 
  111111000111111 
       11111      
