111111  111
122001 11411
122001110001
122000003301
122001010301
122111010301
111103013001
   100310301
   103003001
   100110001
   111111111
