11111              
100011             
10300111111111     
1101010000000111111
1101000313140010001
1001000000301000301
1001110111111111011
1001102252222201011
1101105252252501011
1031111111111011301
1003000300300003001
1001000100010001001
1111111111111111111
