111111111111
100002220301
103335550341
100002220301
111111111111
