11111    
14001    
10331 111
10301 121
111011121
 11000021
 10001001
 10001111
 11111   
