11111111111111
12000000000001
12303030303001
12111111111001
12125030223511
1210303052341 
1212003022331 
1211111111121 
1200000000001 
1213131313131 
1200000000001 
1111111111111 
