111111111  
100000001  
100303031  
110131101  
 102202211 
 112202201 
  101131011
  130303001
  100000041
  111111111
