 111111111      
 100100001111111
 100003000100001
1121111030343101
1222211100110301
1222211113010001
1222200000000301
1110111131030301
1000000001100111
10330301111111  
10011111        
1111            
