         11111  
        1000001 
       100311001
      1001000301
1  1  1010010101
 1 1  1030300301
  11111110131001
  1003030000001 
  142230552111  
   122222211111 
    111111111111
