      11111111    
   11110012221    
   100130022211111
111103000112222001
100033130112222001
103000001111111011
10111031111100301 
10010301410003001 
11010000300330111 
 10001030100111   
 111001100111     
   11000001       
    1111111       
