    11111      
111110001      
100030401      
100301211111   
113011211001111
 10022222031001
 10311211001301
 10001211000001
 11103011111011
   101300000301
   100001110001
   111111 11111
