1111          
100111        
10300111      
1030300111    
103030300111  
103030300001  
1030300100011 
1030011033301 
14011110000011
11010123333321
 1011122222221
 1000255555521
 1111222222221
    1111111111
