        1111111
    11111000001
 11110303030301
 10010030111001
 10000400001301
 10111011100001
 10122222103301
 10122222100311
11312222230001 
10000110100111 
103030003301   
110011111001   
 11110001111   
