    11111        
    10001        
    13001        
  111003111      
  100300301      
11101011101111111
10001011101100221
10300300000040221
11111011110100221
    1000000111111
    11111111     
