             1 
            11 
           111 
          10001
   111111110101
  1030303030001
 1101212121431 
111222222200011
 1101010101311 
  1030303030001
   111111110101
          10001
           111 
            11 
