     111111111
     100000001
     100313101
 1111110010301
 1000103003001
11030000011101
10001311110001
10000301110111
1111122041011 
   1222303301 
   1222100001 
   1222111111 
   11111      
