      1111 
1111111001 
1000003001 
1000311431 
1131222101 
 103222001 
 1012021011
 1000101301
 1300300001
 1001111111
 1111      
