   111111       
   1000011      
   10303011     
11110131001111  
1030000300100111
1000030103222221
1110101111222221
 110130300221111
 100100031001   
 143003001111   
 100111111      
 1111           
