1111111111111111 
1000000000000001 
1010111111000001 
1010030303031001 
10100034300011011
10101303031112221
10100030300112221
10111333030112221
10000010110112221
11111000110112221
    1111100000111
        1000001  
        1111111  
