            11111 
  111111111 10001
 1100000001110131 
 1003010303010001 
 10031110100013011
111001110003000001
100010000301030001
103313113101111001
104300222231001111
111103222201      
   110222211      
    1122221       
     111111       
