        1111111    
    11111001001111 
    10001000300001 
 11110133011011001 
1100000010100110111
1001110313003003001
1222000010110010001
1222100004010111011
1222100111004004001
11111111 1100010001
          111111111
