     111111   
   111000011  
   100011001  
 11131100101  
110000022101  
100313152101  
10334032510111
10033012210001
11000012230001
 1113112010111
   100111001  
   110000011  
    1111111   
