 11111  
 140111 
 103001 
11101011
12101001
12300101
12000301
11111111
