11111111 
12222221 
100301011
103010301
113030301
 10040001
 11111111
