      111111111
      100000001
      130333001
      100010301
      100034301
    11130301011
    1000313101 
11111010010001 
12220010310111 
122222000101   
122222103101   
111111110001   
       11111   
