  11111     
  1000111111
111312000001
103022210301
140321530001
111100001111
   111111   
