        111111111
      11100010001
      14300303301
111 1111110000001
12111000110011301
12222252001103001
10511001301003001
10001003002222221
11031100111111111
 10301111        
 1030301         
 1000001         
 1111111         
