111111   
100001   
1033311  
100122111
110022301
 10400001
 11111111
