11111 1111
12221 1001111
1222111003001   
122221103003111 
112222110003001 
111222011030301 
101100001003001 
1001101011101111
1030101300300001
1003040300003001
1000103033030111
10011111100111  
1011    1111
111             
