111111111     
1000000011    
10131314011111
10300003010001
11011110110101
10010010000001
10310030011111
12230011010001
12210010003301
12211110030001
15222103030301
12222100000001
11111111111111
