11111111 
10000001 
10133001 
10222101 
112223011
 10110301
 13003001
 10010041
 11111111
