111111111 
100011001 
101030301 
100521001 
110124211 
1131115111
1000000001
1000110101
1111110001
     11111
