1111111
1223221
1221221
1033301
1003001
1033301
1001401
1111111
