    1111111111     
 11110000000001111 
 10000103110100001 
 10110130230101101 
1101000012330001011
1000011312101100301
1010222222222220101
1010011312141131101
1011300302130300001
1000010302000110111
11110113113311001  
   10000000000011  
   1111111111111   
