   11111   
   10401   
   10301   
   13231   
 11123211  
11023232111
10032323001
10000200001
11111111111
