11111           
12221 11111
12221110001     
122220003311111 
1222200100100011
1221311110131001
1103001000003301
1003104030331001
1030303010003011
100010030110001 
111111000111111 
     11111      
