   11111111
11110000201
10030303201
10021111211
1032303041 
1002001111 
1111111    
