   111111111
   100010001
   100000001
111115111011
10002220001 
101015111311
103000030001
111114010001
    11111111
