  11111111       
  10000001       
  100300011111   
  111100030001   
  100113103001   
  100004101011111
 1101103030330001
 1000100100010001
11000111111111111
122221           
122221           
111111           
