    1111    
111110011111
100003000301
100313110001
111012520111
  10222041  
  11013111  
   10001    
   11111    
