1111     1111
100111111122111 
103030300122221 
103000330155521 
103030300122521 
100303030152521 
1103030302525211
1003030302525241
1003030301525211
103030300122521 
103000330155521 
103030300122221 
100111111122111 
1111000001111   
