  11111  
  10401  
  10301  
111020111
100050001
105555501
100050001
111353111
  10201  
  10501  
  10201  
  11111  
