 111111 
 120221 
 120321 
11100311
10300301
10131101
10004001
11111111
