 1111111  
 1222201  
1112223111
1003130301
1033001301
1000010001
1111040111
   11111  
