       111111111
1111111141100221
1000000300000221
1030130131100221
1101100001111221
 103031101001111
 101101001      
1101000011      
100300011       
10011301        
10011001        
11111111        
