   1111111111    
  110011000011111
 1100030010300301
 1000311003310001
 1000030001000001
 1311110111110001
 1010222222204011
11000252525201011
10001111110111001
10130000030000301
10001111111111111
11111            
