111111  11111
1000011110001
1030003000101
1100101110301
 133001113101
1100010022201
1001030032221
1001111122111
1041   1111
1111         
