11111111
10000021
14030301
10000021
11111111
