   111111 
 11100001 
1120311011
1223030041
1220303011
111111001 
     1111 
