  11111   
1110001111
1000303001
1030003041
1113311111
  100221  
  122221  
  111111  
