   1111111111   
   1220010001   
   1220000001   
   122001001111 
  11111110010011
  10000000000001
  10010011001001
1111011001111011
1003001111101001
1010300300103001
1043003000100011
111101101111111 
   100001       
   111111       
