 111111
1100001
1050301
1233211
1204021
1123321
1030501
1000011
111111 
