      1111    
      1001    
  11111031    
  100300011   
111000303011  
10001010000111
10002221030001
10312221301101
10002221031001
11012223400011
 101130330111 
 1000000111   
 11111111     
