1111      1111
12211111111221
15252222252521
10303030303031
13030343030301
10303030303031
13030303030301
12525222225251
12211111111221
1111      1111
