111111111111111111
100000000011012221
103033100003012221
103000131133012221
103313004000002221
103030313011110021
100011000000032221
111111111111111111
