 11111     
 1040111111
 1012250001
 1022210001
11311030301
10001311111
100030001  
111110101  
    10001  
    11111  
