    111111      
 11110000111111 
 10010300001001 
 10300133003301 
 10031001221201 
113001012225211 
103010302211201 
1013030122222001
100001001001111 
1031001000411   
100003101001    
111100301111    
   100111       
   1111         
