      1111     
      100111111
      100001001
      103300001
111111131001001
100125220111311
100121523000001
100121251010001
103322221011111
10430101101    
10333100001    
10000111111    
111111         
