    11111   
   110001111
   102250301
111101210001
100002521411
10131131101 
10000030301 
11001000111 
 11111111   
