         1111     
 1111111110011    
110030000003011111
100011011000112221
101330303313112221
101000040010002221
100310333110002221
103003300301122221
111300000001111111
  1001111111      
  1111            
