   11111 
111120011
103232001
143101301
103202001
111131301
  1202001
  1111111
