  11111111    
  1000100111  
11101030030111
10000133010001
10113100400301
10000331113011
1000310110011 
101301022211  
10301222221   
11002222211   
 103101111    
 110001       
  11111       
