      1111111111 
 1111 1001101001 
 100111031003301 
 100000000000001 
 100110113111011 
1100301030011301 
10011110010100011
10010300030103001
10000301222100001
11303010222111111
140011102221     
11111 111221     
        1221     
        1111     
