 111111111 
 100110001 
 100030001 
 130111031 
 101222101 
11012221011
10300300301
10000010401
11111111111
