     11111       
     14001111111 
   1111030030001 
 111000330303001 
 100010031011111 
 131111003000301 
 103003003000301 
 1003001113111011
11001101222221001
10030301222220001
10300030222221111
11111111222221   
       1111111   
