111100001111111111
100111111000100221
103011000310100221
103000010030100221
103011111010100221
100330303300100221
140000000003003221
100330303300100221
103011111010100221
103000010030100221
103011000310100221
100111111000100221
111100001111111111
