 11111    11111
11222111111000111111
10222211001030110001
10202210001030003301
11222210301101110001
 1222210030000010111
 13111110111000101  
 100001101000111011 
 103331101033400301 
 100301101000110301 
 110101130111110001 
 10303000001  111111
 10000010001        
 11111111111        
