   11111 
   10401 
   13331 
11110001 
100021311
103232021
100121211
11111111 
