  111111  
  10000111
  10300001
1110301101
1222030001
1222313011
1111010301
   1004001
   1111111
