   1111111     
   1000001     
   10303011    
   111112211111
111111225200301
100343222213301
100030131110001
111110000000111
    111001111  
      1001     
      1111     
