  11111        
11100011       
10000001       
103301311111111
110130303010001
122221000300001
122224100111311
122223100030301
122223031000001
111110001031311
    11111000301
        1110001
          11111
