  111111111111111111
  100000001122210001
  101313101112220301
  100430030002210301
11111313101002200111
1000303010111111011 
1010101010000000001 
1000000011111110001 
111111111     11111
