       1       
     11111     
   111040111   
   100303001   
   105252501   
  11023232011  
 1110525250111 
111100303001111
   111111001   
    11   11
