11111      1111
140011111111001
110300000003001
 10101001111001
 10030001111311
 1301101030301 
11030031000001 
10001000000101 
10001111131111 
1111100010001  
    122200301  
    122221001  
    122221111  
    111111     
