 1111     
 10011111 
113011001 
100343001 
100011301 
1112110111
 122230301
 112200001
  11111111
