111111111111111
111210000001111
112210300301001
122210110301001
122222001330001
112222300001301
111101111111001
100030000000011
100301003103011
103111030103301
100041001100001
111111111111111
