111111111111
122201000001
122001011001
122000001001
122001031101
122201303001
111111003301
 11003033001
 14033300101
 11030110001
  1000000001
  1111111111
