  11111           
  1222111111111   
  122210000100111 
  1222300100300011
111222103110000301
100222130013103401
100103001300301111
110100101003001   
 10111103030111   
 100111103011     
 13000000011      
 1001111111       
 1111             
