     11111     
   1110001     
   1000101     
 11100300111111
 10013100100001
 13030110003001
110010000333111
1000011130001  
1031332221111  
10000122221    
10104012221    
10000032221    
11001000001    
 1111111111    
