11111     
1000111111
1030220301
1130223341
 100220301
 111111111
