 1111  111111
 100111100001
1150005055001
1030500005101
1020001110001
1111110001411
1050205005501
1000100010001
1150005013101
 100111110001
 1111   11111
