111111   
100001   
103001111
103522501
105225301
111100301
   104001
   111111
