 111110111111 
 100011100001 
1103030130131 
10030403003011
10100110122221
10011030121121
11003000022221
 1033013122221
 1000100013011
 111110300001 
     11110011 
        1111  
