11111 1111111
1000111001001
1030000030401
1101311211001
 100222520301
 103101210101
 110000300001
  10011111111
  1111       
