 111111111111
 100002010001
 100035010301
 100012010111
 10011210001 
1100112103011
1000102131001
1040102000301
1001105331001
1000102000011
100011111111 
11111        
