        11111111 
        10000001 
        10030301 
 111111110303001 
1122200111101101 
1222200000001101 
11222001103311011
 1111111103000041
      11101111011
      1030300001 
      1003011111 
      110001     
       11111     
