  1111  
  1221  
 110211 
 100321 
11030011
10013301
10040001
11111111
