     11111
 111110001
 102203101
 101250001
1105213011
103003001 
100011041 
111111111 
