11111111111111
10001102222221
10011102212101
10310022112021
11010310100001
10300300001011
10310103111301
14010103001001
10310113101301
10300010000001
11100010113011
  11111000001 
      1111111 
