 11111   
 10001111
110130001
103003301
101312521
100042221
111111111
