 111111 11111
11410011100011
10000300103001
10030010000301
11101111110001
11101100113111
1030011110221 
1030303002221 
1000011112221 
103301  12221
100111  11111
1111          
