     111111   
 1111100001   
 1001003031   
 100301030111 
11001001003011
10310040100001
10000303103301
10030132520111
110010322211  
 11110122221  
    10022221  
    11111111  
