   1111111
  11001041
  10001001
  13030301
  10311001
1110301011
122222001 
111111111 
