    1111      
 1111001111   
 1001000301111
 1222031301001
11212001000301
12222201113001
12222131003011
1113110330001 
 100010000301 
 103004300111 
 1111310111   
    10001     
    11111     
