   1111111111 
1111222222001 
1000222221001 
1001222222011 
110111131131  
14300303000111
10330000110001
10100331100101
10003001033001
10030030001301
11110001030301
   10001000001
   11111111111
