   111111
111120041
100333001
121121121
100030001
100321011
11110001 
   11111 
