 11111111111111 
 104050505010011
 131005050010001
 101050505000001
 101005050011011
 10105050501101 
 10100505001101 
 10105050501101 
 10100505001101 
 101050205011011
1101111111111001
1000000000000001
1000111111111001
11111       1111
