   111111  
   102221  
111122221  
10011130111
10303003301
14030300001
10001110001
11111 11111
