 111111111   
 100011001111
 103000000001
 113111011001
 100110501011
 10322222201 
110111020101 
100000311131 
100010000341 
111113101111 
    10001    
    11111    
