 1111111  
 100000111
1131110001
1040300301
1022103011
112210001 
 11111111 
