 1111111        
 1000001   11111
 100110111110001
 130303001000101
 103030100000001
1100330111311101
1030000122221001
1413301122221001
1003000122224001
1100110122221011
 133100110111001
 100000030000001
 111111111111001
            1111
