    111111111    
    100000001    
    133033101111 
1111100100301001 
1221001103003001 
1221033000001001 
1221001131111011 
122110110000101  
12220001101110111
10001100030000001
11111141000100101
     111111110001
            11111
