1111111111111
1003030325221
1030303052221
1003030325221
1030303052221
1003030325221
1030303052221
1003030325221
1030303052221
1003030325221
1430303052221
1111111111111
