1111111
1000001
1403001
1113101
1000101
1200001
1200001
1203001
1111111
