       1111 1111
     111001 1001
  11110030111031    
  10300030000001    
1110011030030031    
1000000010301101    
1013333103303001    
10000303301111011111
11110000304110222221
 1003311011110222211
 103001222211022111 
 1010032222111111   
 11110022221        
    11111111        
