  1111111111
111000200001
100011311001
104320202311
11031131101 
 1000020001 
 1111111111 
