1111111
1005001
1042301
1032001
1525551
1005001
1035301
1002001
1111111
