  111111111     
  100001001     
11101300301111  
1003001122100111
1010030122303001
1033003122001001
1100100222130001
 130401222103011
 10000122230011 
 1011301110001  
 1000300000111  
 10011111111    
 1111           
